1
20,20
2,2,0,0,0,2,0,0,2,3,2,2,2,2,2,0,2,2,2,2
4,5,4,4,5,4,0,2,2,0,2,2,2,1,4,0,4,2,4,0
4,5,4,4,5,4,2,2,2,0,2,1,1,1,4,2,4,2,4,2
2,2,0,2,0,2,1,1,2,3,5,5,5,1,4,2,4,2,4,2
2,2,0,2,1,2,2,1,8,3,5,5,5,1,4,0,4,2,4,2
1,1,2,2,1,1,0,0,2,3,5,5,5,2,1,0,2,0,2,2
0,2,1,2,0,1,1,2,2,3,5,5,5,1,1,1,1,0,1,1
2,2,0,0,2,0,1,2,1,3,5,5,5,1,4,1,4,2,4,1
2,2,1,0,1,0,2,2,1,3,5,5,5,1,4,2,4,2,4,2
2,1,1,2,2,1,2,2,1,3,1,1,1,2,4,2,4,2,4,2
2,1,1,2,2,0,1,2,8,3,0,0,1,1,4,1,4,2,4,2
0,1,2,2,2,2,2,2,2,3,2,0,0,2,2,2,2,2,1,2
0,2,1,0,0,1,2,2,1,3,3,3,3,3,3,3,3,3,3,3
1,2,2,0,0,0,2,1,1,0,0,2,0,3,1,1,0,0,1,8
2,2,2,2,1,1,2,1,0,1,2,0,8,3,2,6,7,1,6,7
2,2,0,0,1,1,0,0,0,0,2,0,0,3,1,2,2,2,2,2
2,0,1,2,0,2,0,0,2,0,2,0,0,1,2,6,7,0,6,7
0,2,0,2,1,1,0,2,0,1,0,0,1,3,2,2,2,0,0,2
2,2,2,1,2,2,2,0,1,1,0,2,8,3,2,6,7,1,6,7
2,2,1,1,2,1,1,2,0,1,2,2,2,3,0,2,2,2,2,8
